START OF LOG FILE
chromEvol Version: 1.3. Last updated January 2012
_baseNumber	(Int)	5
_branchModelType	(Str)	GRADUAL
_branchMul	(Float)	999
_dataFile	(Str)	simmed.data/Diabrotica.13.4.txt
_demiPloidyR	(Float)	-999
_duplConstR	(Float)	-999
_epsR	(Float)	-999
_epsilonLLimprovement	(Float)	0.1
_freqFile	(Str)	
_gainConstR	(Float)	0
_gainLinearR	(Float)	-999
_inferTreeFile	(Str)	mlAncestors.tree
_logFile	(Str)	log.txt
_logValue	(Int)	5
_lossConstR	(Float)	0
_lossLinearR	(Float)	-999
_mainType	(Str)	Optimize_Model
_maxChrNum	(Int)	-1
_maxChrNumForSimulations	(Int)	0
_maxOptimizationIterations	(Int)	5
_minChrNum	(Int)	-1
_modelType	(Str)	GENERAL_CHR_MODEL
_optimizeIterNum	(Str)	0,2,5
_optimizePointsNum	(Str)	10,3,1
_outDir	(Str)	simmed.data/results/Diabrotica.13.4
_outFile	(Str)	chromEvol.res
_pow2Scale	(Int)	1
_rootAt	(Str)	
_rootFreqType	(Str)	ROOT_LL
_scaleBranch	(Float)	-999
_simDemiTypes	(Str)	-999,-999,-2
_simModels	(Str)	CONST_RATE_NO_DUPL,CONST_RATE,CONST_RATE
_simulationsIter	(Int)	50
_simulationsJumpsStats	(Str)	
_simulationsNum	(Int)	0
_simulationsTreeDir	(Str)	
_simulationsTreeLength	(Float)	0
_startSimulationsIter	(Int)	0
_tolParamOptimization	(Float)	0.01
_treeFile	(Str)	Diabrotica/Diabrotica13.tree

 ---------------------- THE PARAMETERS ----------------------------
main type: Optimize_Model
tree file: Diabrotica/Diabrotica13.tree
data file: simmed.data/Diabrotica.13.4.txt
output file: chromEvol.res
model Type: GENERAL_CHR_MODEL
 max chromosome number allowed: -1
 gainConstR: 0
 _lossConstR: 0
 _duplConstR: -999
 _demiPloidyR: -999

 -----------------------------------------------------------------

cannot open file: simmed.data/Diabrotica.13.4.txt
System Error: No such file or directory
